# Special countries..
REB = "countries/Rebels.txt"
PEL = "countries/Peleponnesia.txt"
CRF = "countries/Corfu2.txt"
ACY = "countries/Ancyra.txt"
AEL = "countries/Aelis.txt"
AKR = "countries/Akroinon.txt"
AME = "countries/Amaseia.txt"
ATL = "countries/Attaleia.txt"
CAP = "countries/Kappadokia.txt"
CIO = "countries/Chios.txt"
CPH = "countries/Cephalonia.txt"
DOR = "countries/Dorylaeum.txt"
EOD = "countries/Eudoxia.txt"
EUB = "countries/Euboea.txt"
GAN = "countries/Gangara.txt"
HIE = "countries/Hierapolis.txt"
ION = "countries/Ionnia.txt"
JUS = "countries/Justinianpolis.txt"
KOO = "countries/Koloneia.txt"
KRS = "countries/Kerasounta.txt"
KST = "countries/Kastoria.txt"
LES = "countries/Lesbos.txt"
LRD = "countries/Laranda.txt"
MGN = "countries/Magnesia.txt"
MOB = "countries/Mobolla.txt"
PLA = "countries/Pelagonia.txt"
RHO = "countries/Rhodes.txt"
SAP = "countries/Sampsounta.txt"
SIN = "countries/Sinope.txt"
SMY = "countries/Smyrna.txt"
SRE = "countries/Serres.txt"
THE = "countries/Thessaly.txt"
TMN = "countries/Timonion.txt"
TPZ = "countries/Trapezus.txt"
TRL = "countries/Tralles.txt"

